############################################################
#                                                          #
#                                                          #
                                                           #
                                                           #
                                                           #
#                                                          #
#                                                          #
#                                                          #
#                                                          #
#                                                          #
#              #########   ####################   ##########
################                       #                   #
#              #                       #                   #
#              #                       #                   #
#              #                       #                   #
               #                       #                   #
               #                       #                   #
#              #                       #                   #
#              #                       #                   #
############################################################