#########       #############################        #######################
#                                #                                         #
#                                #                                         #
#                                                                           
#                                                                           
#                                                                           
#                                                                           
#                                                                          #
#                                #                                         # 
#                                #                                         # 
#######        ######################################                      #
#                                #                  #                      # 
#                                #                                         # 
#                                #                  #                      # 
#                                #                  ########################
#                                #                                         # 
#                                #                                         # 
#                                #                                          
#                                #                                         # 
#                                #                                         # 
#                                #                                         # 
############################################################################